1111111111111111111111111111111111111111
1000000000000000000000000000000000000001
1000000000000000000000000000000000000001
1000000022222222222222222000090000200001
1000000010000000000009000000000000200001
1000002220000300000000000000000000200001
1000000000000000000000000000000000200001
1000000000011111111111111112222222200001
1000000000000000000000000000000000000001
1000000000009000000000000000000000000001
1000000003000000000000000000000000300001
1000000000000000030000000022222000000001
1000000002000000000000000020000000000001
1000000002000000001111112220000000000001
1000000002000000001000000000000000000001
1000000002000030001000000000000000000001
1000000002000000001000002000000000000001
1000000002000000000000002000000000000001
1000000002000000000000002000000000000001
1000000002222220000000001111111100000001
1000000002000000000000000000000000900001
1000000002000000000000000000000000000001
1111111111000000011111111111110000000111
1000000000000030000100000000000000000001
1000000000000000000100000000000000000001
1000000009000000200100000003000000000001
1000000000002222200100900000000000000001
1000300000000000000000000000000000000001
1000000000000000000000000000000000000001
1111111111111111111111111111111111111111